#,#,#,#,#,#,#,#,#,#,#,#
#,W,B,W,B,W,B,W,B,W,B,#
#, , , , , ,15,B,W,B,W,#
#, , , , , ,26,27,28,29,30,#
#,#,#,#,#,#,#,#,#,#,#,#
