#,#,#,#,#,#,#,#,#,#,#,#,#,#,#,#
#,O, , , , , , ,O,#, , , ,#,L,#
#, , , , , , , , ,#, ,#, ,#,L,#
#, , , , , ,B, , ,#, ,#, ,#,L,#
#, , , , , , , , ,#, ,#, ,#,L,#
#,G, , ,B, ,P, ,W, , ,#, ,#,L,#
#, , , , , , , , ,#,#,#, ,#,L,#
#, , , , , ,B, , ,#, , , ,#,W,#
#, , , , , , , , ,#, ,#,#,#, ,#
#,O, , , , , , ,O,#, , , , , ,#
#,#,#,#,#,#,#,#,#,#,#,#,#,#,#,#
