#,#,#,#,#,#,#,#,#,#,#,#,#,#,#,#
#,L,50, , , , , , , , , , ,50,L,#
#,50, , , , , , , , , , , , ,50,#
#, , , , ,B, ,B, ,B, , , , , ,#
#, , , ,B, , , , , ,B, , , , ,#
#, , , , , , ,P, , , , , , , ,#
#, , , ,B, , , , , ,B, , , , ,#
#, , , , , ,#,64,#, , , , , , ,#
#,50, , , , ,#,G,#, , , , , ,50,#
#,L,50, , , ,#,#,#, , , , ,50,L,#
#,#,#,#,#,#,#,#,#,#,#,#,#,#,#,#
