#,#,#,#,#,#,#,#,#,#,#,#,#,#,#,#
#, , , , , , , , , , ,L, , , ,#
#, , , , , , ,#,#,#,#,#,#,#,#,#
#, , , , , , , , , , , , ,#,G,#
#, , , , , , , , , , , , , , ,#
#, , , , , , , , , , , , , , ,#
#, , , , , ,B, , , , , , , , ,#
#, , , ,#,#,A,#,#, , , , , , ,#
#, ,P, ,#,A,A,A,#, , , , , , ,#
#, , , ,#,A,A,A,#, , , , , , ,#
#,#,#,#,#,#,#,#,#,#,#,#,#,#,#,#
