#,#,#,#,#,#,#,#,#,#,#,#,#,#,#,#
#, , , , , , , , , , , , , , ,#
#, ,#,#,#,#,#, , ,#,#,#,#,#, ,#
#, , , , ,L,B, , ,B,L, , , , ,#
#,#,B,#,#,#,#, , ,#,#,#,#,B,#,#
#, , ,#,#,#,#, , ,#,#,#,#, , ,#
#,O, ,#, , ,#,P, ,#, , ,#, ,G,#
#,#,#,#, ,B, , , , ,B, ,#,#,#,#
#, , ,#, , , , , , , , ,#, , ,#
#,A, ,#, , , , , , , , ,#, ,A,#
#,#,#,#,#,#,#,#,#,#,#,#,#,#,#,#
