#,#,#,#,#,#,#,#,#,#,#,#,#,#,#,#
#, , , , , , , , ,#,#,#,#,#,#,#
#, ,P, , , , , , , , , , , ,G,#
#, , , , , , , , ,#,#,#,#,#,#,#
#, , , , , , , , ,#, , , , , ,#
#,#, , , , , , , ,#, , ,L, , ,#
#,#,#, ,L, , , , ,#, , , , , ,#
#,#,#,#,#,#,#,#,#,#,#,#,#,#,#,#
