#,#,#,#,#,#,#,#,#,#,#,#,#,#,#,#
#,A,#, , , , , , , , , , ,#,O,#
#,#,#, , , , , , , , , , ,#,50,#
#, , , , , , , , , , , , , , ,#
#, , , , , ,#,14,#,24,#,46,#, , ,#
#, ,P, ,B, ,#,L,#,L,#,L,#, ,G,#
#, , , , , ,#,12,#,26,#,48,#, , ,#
#, , , , , , , , , , , , , , ,#
#,#,#, , , , , , , , , , ,#,50,#
#,A,#, , , , , , , , , , ,#,O,#
#,#,#,#,#,#,#,#,#,#,#,#,#,#,#,#
