#,#,#,#,#,#,#,#,#,#,#,#,#,#,#,#
#, ,#,L,L,L,L,L,L,L,L,L,L,#, ,#
#, ,#,L,L,L,L,O,O,L,L,L,L,#, ,#
#, ,#,L,L,B,B,B,B,B,B,L,L,#, ,#
#, ,#,L,L,B, , , , ,B,L,L,#, ,#
#,A,#,L,O,B, ,P,G, ,B,O,L,#,A,#
#, ,#,L,L,B, , , , ,B,L,L,#, ,#
#, ,#,L,L,B,B,B,B,B,B,L,L,#, ,#
#, ,#,L,L,L,L,O,O,L,L,L,L,#, ,#
#, ,#,L,L,L,L,L,L,L,L,L,L,#, ,#
#,#,#,#,#,#,#,#,#,#,#,#,#,#,#,#
