#,#,#,#,#,#,#,#,#,#,#,#,#,#,#,#
#, , , ,#, , , , , , , ,#,A,#,#
#, ,G, ,#, , , , , ,B, ,#,13,#,#
#, , , ,#, , , , , , , , , , ,#
#, ,#,#,#,#,W, , , , , , , , ,#
#, ,34,L,28, , , ,28, , ,P, , , ,#
#, ,#,#,#,#,W, , , , , , , , ,#
#, , , ,#, , , , , , , , , , ,#
#, , , ,34, , , , , ,B, , , , ,#
#, , , ,#, , , , , , , , , , ,#
#,#,#,#,#,#,#,#,#,#,#,#,#,#,#,#
