#,#,#,#,#,#,#,#,#,#,#,#,#,#,#,#
#, , , , , , , , , , , , , ,A,#
#, , , , , , , , , , , ,G, , ,#
#, , , , , , , , , , , , , , ,#
#, , , , , , , , , , , , , , ,#
#, , , , , , , , , , , , , , ,#
#, , , , , , , , , , , , , , ,#
#, , , , , , , , , , , , , , ,#
#, , ,P, , , , , , , , , , , ,#
#,L, , , , , , , , , , , , , ,#
#,#,#,#,#,#,#,#,#,#,#,#,#,#,#,#
