#,#,#,#,#,#,#,#,#,#,#,#,#,#,#,#
#, , , , , , ,G, , , , , , , ,#
#, ,O, , , , , , , , , , , , ,#
#, , , , , , , , , , , , , , ,#
#, , , , , , ,B, , , , , , , ,#
#, ,P, , , ,B,A,B, , , , , ,L,#
#, , , , , , ,B, , , , , , , ,#
#, , , , , , , , , , , , , , ,#
#, ,O, , , , , , , , , , , , ,#
#, , , , , , , , , , , , , , ,#
#,#,#,#,#,#,#,#,#,#,#,#,#,#,#,#
