#,#,#,#,#,#,#,#,#,#,#,#,#,#,#,#
#,L, , ,#, , , , , , , , ,G, ,#
#,L, , ,#,#, , , , , , , , , ,#
#,L, , , , , , , , , , ,#,#,#,#
#,L, , ,#,#, , , , ,B, , , , ,#
#,L, , ,#, , , , , , , ,#,#, ,#
#,L, , ,#, ,B, , , , , , ,#, ,#
#,L, , ,#, , , , , , , , ,#, ,#
#,L, , ,#, ,P, , , , , , ,#, ,#
#,L, , ,#, , , , , , , , ,#,L,#
#,#,#,#,#,#,#,#,#,#,#,#,#,#,#,#
