#,#,#,#,#,#,#,#,#,#,#,#,#,#,#,#
#, , , , , , ,#,O, , , , , ,O,#
#, , , , , , ,#, , , , , , , ,#
#, , , ,G, , ,#, , , , , ,#,32,#
#, , , , , ,#,L,#, , , , ,#,L,#
#, ,B, ,P, ,15,15,15, , , ,B, ,34,#
#, , , , , ,#,A,#, , , , ,#,A,#
#, , , , , , ,11,#, , , , ,#,#,#
#, , , , , , , ,#, , , , ,40,L,#
#, , , , , , ,#,#,O, , , ,40,L,#
#,#,#,#,#,#,#,#,#,#,#,#,#,#,#,#
