#,#,#,#,#,#,#,#,#,#,#,#,#,#,#,#
#,L, , , ,#,A,A,#, , , , , ,O,#
#, , , , ,#,#,#,#, , , , , , ,#
#, , , , , , , , , , ,B, , , ,#
#,#,#,#,#,#,#,#,#, , , ,P, , ,#
#,L,L, , , , , , , , ,B, , ,G,#
#,#,#,#,#,#,#,#,#, , , , , , ,#
#, , , , , , , , , , ,B, , , ,#
#, ,#,#,#,#,#,#,#, , , , , , ,#
#, , , , , , ,L,#, , , , , ,O,#
#,#,#,#,#,#,#,#,#,#,#,#,#,#,#,#
