#,#,#,#,#,#,#,#,#,#,#,#,#,#,#,#
#, , , , , , , , , , , , ,#,#,#
#, ,#,B,#,#,#,#,#,#,#, , , , ,#
#, ,#, , ,#, , , , ,#, , , , ,#
#, ,#, , ,#, ,P, , ,#, , , , ,#
#, ,#,G, ,#, , , , ,#, , , , ,#
#, ,#,#,#,#, ,B, , ,#,#,#,B,#,#
#, ,#,L, ,#, , , , , , , , , ,#
#, ,#,#, ,#,#,#,#,#,#,#,#,#, ,#
#, , , , , , , , , , , , ,#,L,#
#,#,#,#,#,#,#,#,#,#,#,#,#,#,#,#
