#,#,#,#,#,#,#,#,#,#,#,#,#,#,#
#,L, , , , , , , , , , ,#,A,#
#,#,#,#,#,#,#,#, ,P, , ,#,#,#
#,L,#, , , , , , ,B, , , ,#,#
#, ,#, , , , , , , , , , ,#,#
#, ,#, ,O, , , , ,B, ,G, ,#,#
#, ,#, , , , , , , , , , ,#,#
#, ,#, , , , , , , , , , ,#,#
#, ,#,#,#,#,#,#,#, , , ,#,#,#
#, , , , , , , , , , , ,#,A,#
#,#,#,#,#,#,#,#,#,#,#,#,#,#,#
