#,#,#,#,#,#,#,#,#,#,#,#,#,#,#
#,O,32, , , , , , , , , ,32,G,#
#,#,#, ,P, , , , , ,B, ,#,#,#
#, ,#, , , ,#,32,#, , , ,#, ,#
#, ,#, , ,#,#,W,#,#, , ,#, ,#
#, ,#, , ,32,W,L,W,32, , ,#, ,#
#, ,#, , ,#,#,W,#,#, , ,#, ,#
#, ,#, , , ,#,32,#, , , ,#, ,#
#, ,#, ,B, , , , , , , ,#, ,#
#,A,#, , , , , , , , , ,#,A,#
#,#,#,#,#,#,#,#,#,#,#,#,#,#,#
