#,#,#,#,#,#,#,#,#,#,#,#,#,#,#,#
#,A, ,#, , , , , , , , , , , ,#
#, , ,#, , , , ,B, , , , ,O, ,#
#,#,#,#, , , , , , , , , , , ,#
#, , , , , ,#,#,#,#,#, , ,#,#,#
#, ,G, ,P, ,30,L,#,L,14, , ,#,#,#
#, , , , , ,#,#,#,#,#, , ,#,#,#
#,#,#,#, , , , , , , , , , , ,#
#, , ,#, , , , ,B, , , , ,O, ,#
#,A, ,#, , , , , , , , , , , ,#
#,#,#,#,#,#,#,#,#,#,#,#,#,#,#,#
